##############################################################################
##############################################################################
##############################################################################
#####                  #######################################################
#             ################################################################
#####         ################################################################
##### ####      ##############################################################
##########     ###############################################################
###########    ###############################################################
###########     ##############################################################
############      ############################################################
#############     ############################################################
###############    ###########################################################
###############                            ###################################
###############                                      #########################
#########################                            #########################
####################################          #            #  ################
##################################    #################      #################
###########################################        #  #  # # # #   ###########
########################################         # # ##  #    #    ###########
#####################################################      #   ###############
#############################################                #   #############
####         ################################      #### ## # #################
###                   #######################                       ##########
#                     ######################            #### #     # #########
#                     ####################           #                 #  ####
###              #### #############       # ##           ### ####  ###  ##  ##
###         ######### ##################### ## # #             #           ###
###         ######### ##################         # # # #  #            #######
###        ########   ##################      # ## ## # ##    ####  # ########
####       ######## #######################      ### #######  ##   ###########
################### ##########################     #         ##  #############
###################   #########################  ##### #  # ## ###############
#####################   ######################            ###    #############
#######################     ##################   #               #############
###########################    ################               #     ## # #####
##############################   #################  # #          #  ###    ###
################################    ###############                    #######
###################################     ##########                 ###########
######################################  ############    ######################
#######################################          # # #   #####################
######################  ######### ####  ######################################
###########       # # #   # ############  ####################################
###########    #  ###  ## # #   # ###   ######################################
############## ##  ## # # ## #      #### ###      ############################
##############  ## #### ###  #####       # ###################################
#####                   ###### # # # ####   ## ###   #########################
#             ##########  # #   # #### ####   ### ############################
#####          # ### ## ##################### ################################
##### ####      ##### ######### ## ### ##### #  ##############################
##########     ######## #  ###### #### ##### ## ##############################
###########    #########  ### # # ### #### ######   ##########################
###########     #####  ### ###################################################
############        ##########################################################
#############       ## ############# ####### ####### ### ##  #################
###############    ############   ##### ##### #### ###  ## ###################
###############                            ##  #  ############################
###############                                      #########################
#########################                            #########################
######################## # #########          #            #  ################
####################### # ### ####     ## #############      #################
###########################################        #  #  # # # #   ###########
########################################         # # ##  #    #    ###########
#####################################################      #   ###############
#############################################                #   #############
####         ################################      #### ## # #################
###                   #######################                       ##########
#                     ######################            #### #     # #########
#                     ####################           #                 #  ####
###              #### #############       # ##           ### ####  ###  ##  ##
###         ######### ##################### ## # #             #           ###
###         ######### ##################         # # # #  #            #######
###        ########   ##################      # ## ## # ##    ####  # ########
####       ######## #######################      ### #######  ##   ###########
################### ##########################     #         ##  #############
###################   #########################  ##### #  # ## ###############
#####################   ######################            ###    #############
#######################     ##################   #               #############
###########################    ################               #     ## # #####
##############################   #################  # #          #  ###    ###
################################    ###############                    #######
###################################     ##########                 ###########
######################################  ############    ######################
################################### # #          # # #   #####################
################################# #### ## ##  ################################
############################ ## ###  # # #     ###############################
########################### ## #  ## ## #   # # ##############################
####################### # #  #   # ##  ####  #################################
####################    #### #####   #####  # #  #  ##########################
#####                  ### ######### ### # #### ##### ########################
#             ####  ## ## ########## #   ### #######  ########################
#####         ##### #     # ##### #   ########### # ##########################
##### ####      ####  #     #           ###  # # #############################
##########     ####### #  #   #### # #####   ######  #########################
###########    ####    #####      #    ## ##  ######  ########################
###########     ## ##  #####  ##### # ####   #######  ########################
############        ###  ##### #  ##  ## #########  ##########################
#############     ## ### #  #      # # #  ## #  ##############################
###############    ############  ### ########## ##############################
###############                            # # ###############################
###############                                      #########################
###################### ##                            #########################
######################  # ## ##  ###          #            #  ################
################################        ###############      #################
################################### # #####        #  #  # # # #   ###########
###############################  # #####         # # ##  #    #    ###########
################## ##### # ## #######################      #   ###############
#############################################                #   #############
####         ################################      #### ## # #################
###                   #######################                       ##########
#                     ######################            #### #     # #########
#                     ####################           #                 #  ####
###              #### #############       # ##           ### ####  ###  ##  ##
###         ######### ##################### ## # #             #           ###
###         ######### ##################         # # # #  #            #######
###        ########   ##################      # ## ## # ##    ####  # ########
####       ######## #######################      ### #######  ##   ###########
################### ##########################     #         ##  #############
###################   #########################  ##### #  # ## ###############
#####################   ######################            ###    #############
#######################     ##################   #               #############
###########################    ################               #     ## # #####
##############################   #################  # #          #  ###    ###
################################    ########   ####                    #######
########################    #######     ###   ####                 # #########
################## ## ## # #######   #  ##   #######    ####### # #  #########
####### #######  ###### #######  #   ##          # #     ###  #   # ##########
############# ###   # #           #    # ## #            # ### ### ###########
##########                                 #           # ## # ################
#########  # #   #   ##                     # # #  #    ###  ## ##############
#####     #          #            ### #                ### ##### #############
##   #### # ## #  #               #                 # #  ######## ############
#  #                    #      #      ##        #  #    ######################
#             ##### #     ### #    #      #       ##   #### # # ##############
#####          ##      #      #   ###  ####  ##   ## ####### # ###############
##### ####      #     ## # ##### ##  # ##    #      ## ### ##### #############
##########          #      ##     ##    #  ## #     ## ########  # ###########
###########       ##  #   ##   #   #  #    # #    ###   ####### ## ###########
###########     # #### # #  # ##  # ###  # ##   ##  #  ######  ##  ###########
############      ##     #  ##      # ## ### # ## ##  # #### ### #############
############      # ##    #### #####  ##  ##    ####   ######   ##############
##########  ###    ###  ##  # # ## #### # #### ### # #####    # ##############
###############                            # ###  # #  #      ################
#######   ### #                                      ## #  # #################
####### #####  ##  ######                            ###  # ##################
############# ###     ######    ###           #            #  ######  ########
############ #### #  #### ########     ## #####  ###         #### # # ########
########### ###   #####  # ######## ##   #         #  #  # # #     # #########
#########   ########### #   ######## ###           # ##  #    #    ###########
#########  ### ## #### # ## ####       ##   # #######      #   ## ############
##########   #  ###### # ####   #  #  ###   #                #    ############
####         ## #### ### ###              ##       ####  # # ## ##############
###                   ######                #                       ##########
#                     #####      #        ##            #### #       #########
#                     # #  ##                        #                 #  ####
###              ####      ##     #       #  #            #        ###  ##  ##
###         #########  ####         # #####  # #               #           ###
###         #########  #     #     # #           # # #                 #######
###        ########   # #           #         # ## ##   ##    ####  # ########
####       ######## ###### ##    ## #######      ### ##### #  ##   ###########
##################  #####   ## ##  #       #                 ##  #############
###################   ####  #       #####   ###  ##### #  # ## ###############
#####################   ########## ## ###  ###            ###    #############
#######################     ##################   #               #############
###########################    ################               #     ## # #####
##############################   #################  # #          #  ###    ###
################################    ###############                    #######
###################################     ##########                 ###########
######################################  ############    ######################
#######################################          # # #   #####################
##############################################################################
##############################################################################
