+----------------------------+-------------------------------------------+
|            +---------------+                                           |
|            |               |                                           |
|            |               |                                           |
|            |               +------+                                    |
|            |               |      |   +--------------------------------+
|        +---+---------------+------+---+------+                         |
|        |   |               |      +-- |      |                         |
|        |   |               |                 |                         |
|        |   |               |                 |                         |
|        |   |               |                 |                         |
+--------+---+---------------+-----------------+--------+                |
|        |   |     +---------+-----------------+---+    |                |
|        |   |     |         |                 |   |    |                |
|        |   |     |         |                 |   |    |                |
|        |   |     |         |                 |   |    |                |
|        |   |     |         |      +----------+---+----+---------------+|
|        |   |     |         |      |          |   |    |               ||
|        |   |     |         |      |          |   |    |               ||
|        |   |     |         |      |          |   |    |               ||
|        |   |     |         |      |          |   |    |               ||
|        |   |     +---------+------+----------+---+    |               ||
|        |   |               |      |          |        |               ||
|        |   |               |      |          |        |               ||
|        |   |               |      |          |        |               ||
|        |   |               |      |          |        |               ||
|        |   |               |      |          |        |               ||
|        |   |               |      |          |        |               ||
|        +---+---------------+------+----------+        |               ||
+------------+---------------+------+-------------------+               ||
|            |               |      |                                   ||
|            |               |      |                                   ||
|            |               |      |                                   ||
|            |               |      |                                   ||
|            +---------------+      |                                   ||
|                                   |                                   ||
|                            +---+  |                                   ||
|                            |   |  |                                   ||
|                            |   |  +-----------------------------------+|
|                            |   |                                       |
|                            |   |                                       |
|                            |   +------+                                |
+-------\       \------------+          |                                |
|        \       \                      |                                |
|         \       \                     |                                |
|          \       \                    |                                |
+-----------\       \--------------+    |                                |
|                                  |    |                                |
|                                  |    |                                |
|                                  |    |                                |
|                                  |    |                                |
|                                  |    |                                |
|                                  |    |                                |
|                                  |    |                                |
+----------------------------------+----+--------------------------------+
